NO textures/Icon4.xpm 
SO textures/Icon3.xpm
WE textures/Icon2.xpm
EA textures/Icon1.xpm
C 255,111,255
F 255,111,119

        1111111111111111111111111
        1100000000000000000000001
        1000000000000000000000001
111111110000000000000000000000001
10000000000000000000000000000111
10000000000000E10000000000001
10000000000000000000000000111
10000000000000000000000000001
10000000000000000000000000001
10000000000000000001010000001
11000001110101011111011110101
11110101 1110111 101111010001
111111111 1111111 111111111111