





NO ./textures/epic.xpm
SO ./textures/epic.xpm
WE ./textures/epic.xpm
EA ./textures/Icon10.xpm
F 50,50,50
C 160,32,255

1111111111111111111111111
1000000000000000000000001
1000000000000000000000001101
10000
000000000N000000000001
1000000000000000000000011111
100000000000000000000001
111111111111111111111111111
