NO ./textures/epic.xpm
SO ./textures/epic.xpm
WE ./textures/epic.xpm
EA ./textures/epic.xpm
F 164,169,20
C 153,204,255

11111111111111111
10000000000000001
10000000000000001
10000000000000001
10000000000000001
10000000N00000001
10000000000000001
10000000000000001
10000000000000001
10000000000000001
11111111111100001
			10011111111
			10000000001
11111111111111111111101
10000000000000000000001
11111101110111111111111
10000000000000000000001
11111111110000000000001
11111111110000000000001
11111111111111111111111
