WE ./textures/epic.xpm
NO ./textures/epic.xpm
EA ./textures/BrickLightGrey.png
C			153,204,255




SO ./textures/epic.xpm










F 164,169,20

11111111111111111
10000000000000001
10000000000000001
10000000000000001
10000000000000001
10000000N00000001
10000000000000001
10000000000000001
10000000000000001 
10000000000000001
10111111111100001
101			10001111111
101			10000000001
1011111111111111111101
10000000000000000000001
11111101110111111111111
10000000000000000000001
11111111110000000000001
11111111110000000000001
11111111111111111111111

