NO ./textures/epic.xpm
SO ./textures/epic.xpm
WE ./textures/epic.xpm
EA ./textures/epic.xpm
F 50,50,50
C 160,32,255

11111111111
10000000001
10000000001
10000000001
10000000001
10000000001
11111111111