        NO          ./textures/epic.xpm
		SO ./textures/epic.xpm
   			WE ./textures/epic.xpm
  			EA ./textures/epic.xpm
F 164,169,20
C 153,204,255

	11111
	10001
111110001
10S000001
111111111