WE ./textures/epic.xpm
NO ./textures/epic.xpm
EA ./textures/epic.xpm
C			153,204,255



SO ./textures/epic.xpm









F 164,169,20
          11111111111111111111111111111  111
        11  10000000000000001
1111111110111011111111111111101111        111111111000
         10000000000000S1111111                       
111111111111100000000001111111111111
             111110000000000000000111111
             1111111111111101111111111111111111111
             111111111111111