
EA                                                                                                                                                          ./textures/epic.xpm
WE                                                                                              ./textures/epic.xpm

SO ./textures/epic.xpm
C	                    	153,204,255



            F   	164,169,20

NO ./textures/epic.xpm



11111111
100000011111
1111100111111111
    111110000001
1	1000N0011111
111110000001
100000011111
11111111