
EA                                                                                                                                                          ./textures/epic.xpm
WE                                                                                              ./textures/epic.xpm

SO ./textures/epic.xpm
C	                    	153,204,255



            F   	164,169,20

NO ./textures/epic.xpm


	11111111
	10000001
	11111001
	1	1001
	1	1001
111111110001
100010000001											111111111111111111111111111111111111111111111111111111111111111111111111111111111111111111111111111111111111111111111111111111111111111111111111111111111111
111011111011											1		1			11	1			11																							 1
1110111110110	0	0	0	0			0000		00		0	0		000			00					00		0	0	0	0	0		000												00	01
111011111011											1					11	1			11																								1W1
111011111011											1					11	1			11																							 	 1
11100000001
  111111111