NO textures/Icon4.xpm 
SO textures/Icon3.xpm
WE textures/Icon2.xpm
EA textures/Icon1.xpm
C 255,111,255
F 255,111,119

    1111111111111111111111
1100000000000000000001
1000000000000000000001
1000000000000000000001
100000000000000N000001
1000000000000000000001
1000000000000000000001
1000000000000000000001
1111111111111111111111