NO textures/Icon6.xpm 
SO textures/Icon6.xpm
WE textures/Icon6.xpm
EA textures/Icon6.xpm

F 220,111,119

C 225,111,200

1111111111111111111111
1100000000000000000001
1000000000000000000001
1000000000000000000001
100000000000000N000001
1000000000000000000001
1000000000000000000001
1000000000000000000001
1000000000000000000001
1111111111111111111111


XXXXX1
XXXX10111111
XXX100000001
XXX111111111